WWWWWWWWWW
W S      W
W  HHHH  W
W AC CCb W
W    WXXXW
W YC   C W
W  B W C W
W    W   W
WR TR  X W
WWWWWWWWWW