WWWWWWWWWW
W  B     W
W  HHHH  W
W V    b W
W  C WXXXW
W    W
W  S W Y W
W    W   W
W R  A T W
WWWWWWWWWW