WWWWWWWWWW
W    B   W
W  HHHH  W
W VC CCb W
W  C WXXXW
W    W
W   CW   W
W  S W   W
WT  RA T W
WWWWWWWWWW