WWWWWWWWWW
W        W
W  HHHH  W
W      b W
W B  WXXXW
W        W
W S  W   W
W    W    
W T      W
WWWWWWWWWW