WWWWWWWWWW
W  S     W
W  HHHH  W
W    C b W
W    WXXXW
W        W
W   BW   W
W    W   W
W  C X   W
WWWWWWWWWW