WWWWWWWWWW
W   B    W
W        W
W      T W
W    WXXXW
W         
W  S     W
W        W
W  C   b W
WWWWWWWWWW