WWWWWWWWWW
W  S     W
W  HHHH  W
W V  C b W
W    WXXXW
W O      W
W   BW   W
W    W   W
W R    T W
WWWWWWWWWW