WWWWWWWWWW
W     R  W
W  HHHH  W
W   A B  W
W   OWXXXW
W   O    W
W  S W   W
W      R W
W R    X W
WWWWWWWWWW