WWWWWWWWWW
W        W
W  HHHH  W
W      b W
W    WXXXW
W      C W
W T SW C W
W    W   W
W B  X   W
WWWWWWWWWW