WWWWWWWWWW
W  S     W
W  HHHH  W
W      b W
W    WXXXW
W        W
W   BW   W
W    W    
W        W
WWWWWWWWWW