WWWWWWWWWW
W    S   W
W  HHHH  W
W VA CCb W
W  A WXXXW
W    W
W   CW   W
W  B W   W
WT  RA T W
WWWWWWWWWW