WWWWWWWWWW
W        W
W  HHHH  W
W    CCb W
W    WXXXW
W      C W
W  S W C W
W    W   W
W RB   X W
WWWWWWWWWW