WWWWWWWWWW
W     R  W
W  HHHH  W
W     B  W
W    WXXXW
W        W
W  SOW   W
W      R W
W R    X W
WWWWWWWWWW