WWWWWWWWWW
W  B S   W
W  HHHH  W
W V    b W
W  C WXXXW
W    W
W   CW Y W
W  C W   W
W R RA T W
WWWWWWWWWW