WWWWWWWWWW
W        W
W  HHHH  W
W    CB  W
W    WXXXW
W   O    W
W  S W   W
W      R W
W R    X W
WWWWWWWWWW