WWWWWWWWWW
W  S     W
W  HHHH  W
W V    b W
W    WXXXW
W        W
W   BW   W
W    W   W
W      T W
WWWWWWWWWW