WWWWWWWWWW
W    B   W
W  CHHH  W
W V  CCb W
W    WXXXW
W  C     W
W   CW   W
W  S W   W
W      T W
WWWWWWWWWW