WWWWWWWWWW
W        W
W  HHHH  W
W      b W
W    WXXXW
W      C W
W T SW C W
W T BW   W
W R  X X W
WWWWWWWWWW