WWWWWWWWWW
W  S  B  W
W  HHHH  W
W      b W
W    WXXXW
W        W
W    W   W
W    W    
W        W
WWWWWWWWWW