WWWWWWWWWW
W  B S   W
W  HHHH  W
W VA CCb W
W    WXXXW
W  Y W
W   CW   W
W  C W   W
WT  RA T W
WWWWWWWWWW