WWWWWWWWWW
W  B  S  W
W  HHHH  W
W VR CCb W
W    WXXXW
W    W
W   CW Y W
W  C W   W
WT  RA T W
WWWWWWWWWW