WWWWWWWWWW
W  S B   W
W  HHHH  W
W V    b W
W    WXXXW
W  C     W
W    W   W
W    W   W
W      T W
WWWWWWWWWW