WWWWWWWWWW
W  S     W
W  HHHH  W
W A  C b W
W O  WXXXW
W        W
W   BW   W
W    W   W
W R      W
WWWWWWWWWW