WWWWWWWWWW
W        W
W  HHHH  W
W      b W
W    WXXXW
W      C W
W Y SW C W
WO  BW   W
W TC X X W
WWWWWWWWWW